{
  "tilemap": [
    ["G", "G", "P", "P", "P", "G", "G", "G", "G", "G"],
    ["G", "G", "G", "G", "P", "G", "G", "G", "G", "G"],
    ["G", "G", "G", "G", "P", "P", "P", "P", "P", "G"],
    ["G", "G", "G", "G", "G", "G", "G", "G", "P", "G"],
    ["G", "G", "G", "G", "G", "G", "G", "G", "P", "G"],
    ["G", "G", "G", "G", "G", "G", "G", "G", "P", "G"],
    ["G", "G", "G", "G", "G", "G", "G", "G", "P", "G"],
    ["G", "G", "G", "G", "G", "G", "G", "G", "P", "G"],
    ["G", "G", "G", "G", "G", "G", "G", "G", "P", "G"],
    ["G", "G", "G", "G", "G", "G", "G", "G", "P", "G"]
  ],
  "path": [
    [2, 0], [3, 0], [4, 0], [4, 1], [4, 2], [5, 2], [6, 2], [7, 2], [8, 2],
    [8, 3], [8, 4], [8, 5], [8, 6], [8, 7], [8, 8], [8, 9]
  ]
}
